bbbbbbbbbbbbbbbbbbbbbbbbbbbbbbbbbbbbbbbbbbbbb
b-------------------------------------------b
b-------------------b-----------------------b
b----------b--------------------------------b
b------------------------b------------------b
b-------------b-----------------------------b
b------b------------------------------------b
b-------------------------------------------b
b-------------------------------------------b
b-------------------------------------------b
b---------------------b---------------------b
b-------------------------------------------b
b-------------------------------------------b
b--------------b----------------------------b
b---------------------------b---------------b
b-------------------------------------------b
b-----b-------------------------------------b
b-------------------------------------------b
b-------------------------------------------b
b-------------------------------------------b
b-------------------------------------------b
b--------b----------------------------------b
b-------------------------------------------b
b------------------b------------------------b
b-------------------------------------------b
b-------------------------------------------b
b-------------------------------------------b
b-------------------------------------------b
b-------------------------------------------b
b-------------------------------------------b
b-------------------------------------------b
b-------------------------------------------b
b-------------------------------------------b
b-------------------------------------------b
b-------------------------------------------b
b-------------------------------------------b
b-------------------------------------------b
b-------------------------------------------b
b-------------------------------------------b
b-------------------------------------------b
b-------------------------------------------b
b-------------------------------------------b
b-------------------------------------------b
b-------------------------------------------b
bbbbbbbbbbbbbbbbbbbbbbbbbbbbbbbbbbbbbbbbbbbbb