bbbbbbbbbbbbbbbbbbbbbbbbbbbbbbbbbbbbbbbbbbbbbbbbbb
bssssssssssssssssssssssssssssssssssssssssssssssssb
bssssssssssssssssssssssssssssssssssssssssssssssssb
bssssssssssssssssssssssssssssssssssssssssssssssssb
bssssssssssssssssssssssssssssssssssssssssssssssssb
bsssssssssssss3sss3ssssssssssssssssssssssssssssssb
bssssssssssssssssssssssssssssssssssssssssssssssssb
bssssssssssssssssssssssssssssssssssssssssssssssssb
bssssssssssssssssssssssssssssssssssssssssssssssssb
bssssssssssssssssssssssssssssssssssssssssssssssssb
bssssssssssssssssssssssssssssssssssssssssssssssssb
bssssssssssssssssssssssrrrsssssssssssssssssssssssb
bssssssssssssssssssssssrrrsssssssssssssssssssssssb
bsss----------------sssrrrsssss---------------sssb
bss------------------ssrrrsss-----------b-------sb
b------b-------------ssrrrss---------------------b
b--------------------ssrrrss---------------------b
b----------------------rrr-------------b-----1---b
b----------------------rrr-----------------------b
b----------------------rrr-----------------------b
b------b--------b------rrr----------1----b-------b
b--1-------------------rrr-----------------------b
b----------------------rrr-----------------------b
b----------------------rrr-----------------------b
b----------------------rrr-----------------------b
b-----------b----------rrr--------b--------------b
b----------------------rrr-----------------------b
b----------------------rrr-----------------------b
b----------------------rrr-------------bbb-------b
b------bbb-------------rrr-----------------------b
b---------------bb-----rrr--------bb-------------b
b----------------------rrr-----------------------b
b--------bb------------rrr-----------------------b
b----------------------rrr--------------b--------b
b----------------------rrr-----------------------b
b------1---------------rrr------------bb---------b
b----------------------rrr-----------------------b
b----------------------rrr------b----------------b
b----------------------rrr-----------------------b
b-------bb-------------rrr-----------------2-----b
b----------------------rrr-----------------2-----b
b----------------------rrr-----------------------b
b--------b-------------rrr---------b-------------b
b--1-------------------rrr-----------------------b
b----------------------rrr--------------------bb-b
b-------------b--------rrr-----------------------b
b----b-----------------rrr-----------------------b
b----------------------rrr-----------------------b
b----------------------rrr-----------------------b
bbbbbbbbbbbbbbbbbbbbbbbrrrbbbbbbbbbbbbbbbbbbbbbbbb