23 48
bbbbbbbbbbbbbbbbbbbbbbbbbbbbbbbbbbbbbbbbbbbbbbbbbb
bssssssssssssssssssssssssssssssssssssssssssssssssb
bssssssssssssssssssssssssssssssssssssssssssssssssb
bssssssssssssssssssssssssssssssssssssssssssssssssb
bssssssssssssssssssssssssssssssssssssssssssssssssb
bssssssssssssssssssssssssssssssssssssssssssssssssb
bssssssssssssssssssssssssssssssssssssssssssssssssb
bssssssssssssssssssssssssssssssssssssssssssssssssb
bssssssssssssssssssssssssssssssssssssssssssssssssb
bssssssssssssssssssssssssssssssssssssssssssssssssb
bssssssssssssssssssssssssssssssssssssssssssssssssb
bssssssssssssssssssssssrrrsssssssssssssssssssssssb
bssssssssssssssssssssssrrrsssssssssssssssssssssssb
bsss----------------sssrrrsssss---------------sssb
bss------------------ssrrrsss-----------b-------sb
b------b-------------ssrrrss---------------------b
b--------------------ssrrrss---------------------b
b----------------------rrr-------------b---------b
b----------------------rrr-----------------------b
b----------------------rrr-----------------------b
b------b--------b------rrr---------------b-------b
b----------------------rrr-----------------------b
b----------------------rrr-----------------------b
b----------------------rrr-----------------------b
b----------------------rrr-----------------------b
b-----------b----------rrr--------b--------------b
b----------------------rrr-----------------------b
b----------------------rrr-----------------------b
b----------------------rrr-------------bbb-------b
b------bbb-------------rrr-----------------------b
b---------------bb-----rrr--------bb-------------b
b----------------------rrr-----------------------b
b--------bb------------rrr-----------------------b
b----------------------rrr--------------b--------b
b----------------------rrr-----------------------b
b----------------------rrr------------bb---------b
b----------------------rrr-----------------------b
b----------------------rrr------b----------------b
b----------------------rrr-----------------------b
b-------bb-------------rrr-----------------------b
b----------------------rrr-----------------------b
b----------------------rrr-----------------------b
b--------b-------------rrr---------b-------------b
b----------------------rrr-----------------------b
b----------------------rrr--------------------bb-b
b-------------b--------rrr-----------------------b
b----b-----------------rrr-----------------------b
b----------------------rrr-----------------------b
b----------------------rrr-----------------------b
bbbbbbbbbbbbbbbbbbbbbbbrrrbbbbbbbbbbbbbbbbbbbbbbbb