bbbbbbbbbbbbbbbbbbbbbbbbbbbbbbbbbbbbbbbbbbbbb
b----2--------------------------------------b
b-------------------------------1-----------b
b------------3------------------------------b
b-------------------------------------------b
b-------------------------------------2-----b
b-1-----------------------------------------b
b-------------------------------------------b
b--1---------2-----3------------------------b
b-------------------------------------------b
b-------------------------------------------b
b----1--------------------------------------b
b-1-----------------------------------------b
b--------4----------------------------------b
b-------------------------------------------b
b-------------------------------------------b
b----3--------------------------------------b
b-------------------------------------------b
b-------------------------------------------b
b-------------------------------------------b
b-------------------------------------------b
b-------------------------------------------b
b-------------------------------------------b
b-------------------------------------------b
b-------------------------------------------b
b-------------------------------------------b
b-------------------------------------------b
b-------------------------------------------b
b-------------------------------------------b
b-------------------------------------------b
b-------------------------------------------b
b-------------------------------------------b
b-------------------------------------------b
b-------------------------------------------b
b-------------------------------------------b
b-------------------------------------------b
b-------------------------------------------b
b-------------------------------------------b
b-------------------------------------------b
b-------------------------------------------b
b-------------------------------------------b
b-------------------------------------------b
b-------------------------------------------b
b-------------------------------------------b
bbbbbbbbbbbbbbbbbbbbbbbbbbbbbbbbbbbbbbbbbbbbb